...###
..##.#.##.#
.##..###..#
##........#
#..#@#.#..#
..#.####..#
..#..#.#..#
.##.##.#.##
.#..##..##
.#.....##
...#####